Username or password incorrect=Գախտնաբառը կամ օգտագործողի անունը սխալ է
Not implemented=Ծրագրավորված չէ
Unathorized=Անհրաժեշտ է մուտք գործել
Empty session id=
Wrong table id=Սխալ սեղանի կոդ
You cannot unlock host thats not locked by you=Դուք չեք կարող բացել սեղանը, որը արգելափակված է ուրիշի կողմից
Table already editing by other user=Սսեղանը խմբագրվում է այլ անձի կողմից
Invalid table id=Սխալ սեղանի կոդ
Order id is empty=Պատվերի համարը դատարկ է
Empty order id=Պատվերի համարը դատարկ է
Invalid order id=Պատվերի համարը սխալ է
Record not exists=Գրանցումը բացակայում է
Need raise your rights=Անհրաժեշտ է համապատասխան իրավասություն
Invalid record id=Գրանցումը բացակայում է
Nothing to print=Ոչինչ տպելու չկա
Missing fiscal info=Բացակայում է հդմ տեղեկատվությաը
Please, call to cashier=Դիմեք գանձապահին
Receipt #=Պատվեր №
Department=Բաժին
Tax number=ՀՎՀՀ
Device number=Սարքի համար
Serial=ԱՀ
Fiscal=Ֆիսկալ
Receipt number=ԿՀ
Date=Ամսաթիվ
(F)=(Ֆ)
Table=Սեղան
Printed=Տպված
Staff=Սպասարկող
Class | Name | Qty | Price | Total=Դաս | Անվանում | Քանակ | Գին | Ընդամենը
Class=Դաս
Total=Ընդամենը
Service=Սպասարկում
Discount=Զեղչ
Need to pay=Ենթակա է վճարման
No service, no discount=Սպասարկումը և զեղչը չի կիրարվում
Payment, cash=Վճարումը կանխիկ
Payment, card=Վճարումը անկանխիկ
Thank you for visit!=Շնորհակալություն այցելության համար
Fiscal machine not configured=ՀԴՄ սարքը կարգավորված չէ
Sample=Օրինակ
Empty order=Դատարկ պատվեր
Order=Պատվեր
New order=Նոր պատվեր
Time=Ժամ
Printer=Տպիչ
This order is not editable=Պատվերը հմբագրման ենթակա չէ
Invalid scancode=Անհայտ բարկոդ
Invalid pin=Սխալ պին կոդ
